fecha,num_casos,num_casos_prueba_pcr,num_casos_prueba_test_ac,num_casos_prueba_otras,num_casos_prueba_desconocida,deceased,cases_accumulated,cases_accumulated_PCR,deceased_accumulated,cases_7_days,cases_14_days,avg_cases_7_days,avg_cases_14_days,ia_100000_week,ia_100000_2week,ia_accumulated
2020-01-31,9,8,1,0,0,,9,8,,9,9,9.0,9.0,0.018974829593380364,0.018974829593380364,0.018974829593380364
2020-02-01,21,19,0,0,2,,30,27,,30,30,15.0,15.0,0.06324943197793455,0.06324943197793455,0.06324943197793455
2020-02-02,18,12,3,1,2,,48,39,,48,48,16.0,16.0,0.10119909116469528,0.10119909116469528,0.10119909116469528
2020-02-03,21,14,4,1,2,,69,53,,69,69,17.25,17.25,0.14547369354924947,0.14547369354924947,0.14547369354924947
2020-02-04,14,10,4,0,0,,83,63,,83,83,16.6,16.6,0.17499009513895225,0.17499009513895225,0.17499009513895225
2020-02-05,16,8,7,0,1,,99,71,,99,99,16.5,16.5,0.20872312552718403,0.20872312552718403,0.20872312552718403
2020-02-06,11,10,1,0,0,,110,81,,110,110,15.714285714285714,15.714285714285714,0.23191458391909336,0.23191458391909336,0.23191458391909336
2020-02-07,16,14,1,0,1,,126,95,,117,126,16.714285714285715,15.75,0.24667278471394474,0.2656476143073251,0.2656476143073251
2020-02-08,9,9,0,0,0,,135,104,,105,135,15.0,15.0,0.22137301192277092,0.28462244390070546,0.28462244390070546
2020-02-09,5,2,1,0,2,,140,106,,92,140,13.142857142857142,14.0,0.19396492473233262,0.2951640158970279,0.2951640158970279
2020-02-10,24,19,5,0,0,,164,125,,95,164,13.571428571428571,14.909090909090908,0.20028986793012607,0.34576356147937554,0.34576356147937554
2020-02-11,16,14,1,0,1,,180,139,,97,180,13.857142857142858,15.0,0.20450649672865504,0.3794965918676073,0.3794965918676073
2020-02-12,24,23,0,0,1,,204,162,,105,204,15.0,15.692307692307692,0.22137301192277092,0.43009613744995495,0.43009613744995495
2020-02-13,34,25,7,0,2,1.0,238,187,1.0,128,238,18.285714285714285,17.0,0.2698642431058541,0.5017788270249475,0.5017788270249475
2020-02-14,20,19,1,0,0,0.0,258,206,1.0,132,249,18.857142857142858,17.785714285714285,0.27829750070291204,0.5249702854168568,0.5439451150102371
2020-02-15,35,31,4,0,0,0.0,293,237,1.0,158,263,22.571428571428573,18.785714285714285,0.33311367508378864,0.5544866870065596,0.6177361189844941
2020-02-16,27,26,0,0,1,0.0,320,263,1.0,180,272,25.714285714285715,19.428571428571427,0.3794965918676073,0.5734615165999399,0.6746606077646352
2020-02-17,36,26,9,0,1,0.0,356,289,1.0,192,287,27.428571428571427,20.5,0.4047963646587811,0.6050862325889071,0.7505599261381567
2020-02-18,29,27,2,0,0,0.0,385,316,1.0,205,302,29.285714285714285,21.571428571428573,0.4322044518492194,0.6367109485778745,0.8117010437168267
2020-02-19,23,18,4,0,1,0.0,408,334,1.0,204,309,29.142857142857142,22.071428571428573,0.43009613744995495,0.6514691493727258,0.8601922748999099
2020-02-20,65,48,13,0,4,0.0,473,382,1.0,235,363,33.57142857142857,25.928571428571427,0.495453883827154,0.765318126933008,0.9972327108521014
2020-02-21,67,58,6,1,2,0.0,540,440,1.0,282,414,40.285714285714285,29.571428571428573,0.5945446605925848,0.8728421612954967,1.1384897756028218
2020-02-22,61,58,1,0,2,0.0,601,498,1.0,308,466,44.0,33.285714285714285,0.6493608349734614,0.9824745100572501,1.2670969539579555
2020-02-23,75,72,1,0,2,0.0,676,570,1.0,356,536,50.857142857142854,38.285714285714285,0.7505599261381567,1.130056518005764,1.425220533902792
2020-02-24,116,103,4,0,9,0.0,792,673,1.0,436,628,62.285714285714285,44.857142857142854,0.9192250780793154,1.3240214427380965,1.6697850042174722
2020-02-25,145,124,10,1,10,0.0,937,797,1.0,552,757,78.85714285714286,54.07142857142857,1.1637895483939957,1.5959940002432151,1.9754905921108223
2020-02-26,169,146,8,1,14,0.0,1106,943,1.0,698,902,99.71428571428571,64.42857142857143,1.4716034506866105,1.9016995881365655,2.3317957255865203
2020-02-27,200,179,9,1,11,0.0,1306,1122,1.0,833,1068,119.0,76.28571428571429,1.756225894587316,2.25167977841447,2.7534586054394175
2020-02-28,336,297,16,2,21,0.0,1642,1419,1.0,1102,1384,157.42857142857142,98.85714285714286,2.3233624679894627,2.9179071285820473,3.4618522435922845
2020-02-29,256,227,8,1,20,0.0,1898,1646,1.0,1297,1605,185.28571428571428,114.64285714285714,2.734483775846037,3.3838446108194984,4.001580729803993
2020-03-01,715,619,32,5,59,0.0,2613,2265,1.0,1937,2293,276.7142857142857,163.78571428571428,4.083804991375308,4.834364917513464,5.5090255252780995
2020-03-02,823,729,26,6,62,0.0,3436,2994,1.0,2644,3080,377.7142857142857,220.0,5.574383271655298,6.493608349734614,7.24416827587277
2020-03-03,811,728,31,1,51,1.0,4247,3722,2.0,3310,3862,472.85714285714283,275.85714285714283,6.978520661565446,8.14231020995944,8.954011253676267
2020-03-04,969,878,25,4,62,2.0,5216,4600,4.0,4110,4808,587.1428571428571,343.42857142857144,8.665172180977033,10.136775631663644,10.996967906563555
2020-03-05,1295,1174,39,3,79,1.0,6511,5774,5.0,5205,6038,743.5714285714286,431.2857142857143,10.973776448171645,12.73000234275896,13.727235053611063
2020-03-06,1653,1495,47,3,108,3.0,8164,7269,8.0,6522,7624,931.7142857142857,544.5714285714286,13.75042651200297,16.073788979992433,17.212278755595257
2020-03-07,1847,1645,42,5,155,3.0,10011,8914,11.0,8113,9410,1159.0,672.1428571428571,17.104754721232766,19.839238497078803,21.10633545103676
2020-03-08,2221,1980,62,2,177,14.0,12232,10894,25.0,9619,11556,1374.142857142857,825.4285714285714,20.27987620652508,24.363681197900387,25.78890173180318
2020-03-09,3424,3093,92,4,235,16.0,15656,13987,41.0,12220,14864,1745.7142857142858,1061.7142857142858,25.763601959012007,31.337985230667304,33.00777023488478
2020-03-10,4691,4255,127,2,307,26.0,20347,18242,67.0,16100,19410,2300.0,1386.4285714285713,33.943861828158205,40.92238248972365,42.897873081834476
2020-03-11,4816,4346,140,4,326,35.0,25163,22588,102.0,19947,24057,2849.5714285714284,1718.357142857143,42.054547322128684,50.719719503105715,53.05151522869224
2020-03-12,6036,5441,171,4,420,55.0,31199,28029,157.0,24688,29893,3526.8571428571427,2135.214285714286,52.050065889041605,63.02384233721325,65.77730094265267
2020-03-13,7939,7083,266,9,581,78.0,39138,35112,235.0,30974,37496,4424.857142857143,2678.285714285714,65.30293020281816,79.05335671482113,82.51520895841341
2020-03-14,7530,6726,227,12,565,104.0,46668,41838,339.0,36657,44770,5236.714285714285,3197.8571428571427,77.28448093383822,94.38923565507099,98.39081638487498
2020-03-15,8065,7106,315,21,623,129.0,54733,48944,468.0,42501,52120,6071.571428571428,3722.8571428571427,89.60547028313988,109.88534648966495,115.39437201494306
2020-03-16,9714,8532,377,16,789,176.0,64447,57476,644.0,48791,61011,6970.142857142857,4357.928571428572,102.86676785451348,128.6303698135255,135.87453808939827
2020-03-17,8938,7960,300,15,663,186.0,73385,65436,830.0,53038,69138,7576.857142857143,4938.428571428572,111.82077910818975,145.76464093634797,154.71865219002424
2020-03-18,9066,8048,297,8,713,234.0,82451,73484,1064.0,57288,77235,8184.0,5516.785714285715,120.78111530506382,162.8356626271925,173.83263053375606
2020-03-19,8763,7839,290,10,624,307.0,91214,81323,1371.0,60015,84703,8573.57142857143,6050.214285714285,126.53048867185807,178.58055456089969,192.30778961451074
2020-03-20,10859,9665,415,13,766,418.0,102073,90988,1789.0,62935,93909,8990.714285714286,6707.785714285715,132.68676671771036,197.98969692052853,215.20197567612377
2020-03-21,7534,6775,225,10,524,494.0,109607,97763,2283.0,62939,99596,8991.285714285714,7114.0,132.69519997530742,209.97968090914566,231.0860163601824
2020-03-22,6920,6097,237,2,584,535.0,116527,103860,2818.0,61794,104295,8827.714285714286,7449.642857142857,130.28117998814957,219.88665027128945,245.67555200309263
2020-03-23,8482,7480,357,15,630,659.0,125009,111340,3477.0,60562,109353,8651.714285714286,7810.928571428572,127.68373664825575,230.55050450276923,263.558274737654
2020-03-24,7327,6512,302,8,505,707.0,132336,117852,4184.0,58951,111989,8421.57142857143,7999.214285714285,124.28724215104066,236.1080212592304,279.0058943410649
2020-03-25,7162,6327,313,7,515,782.0,139498,124179,4966.0,57047,114335,8149.571428571428,8166.785714285715,120.27301153484107,241.05412683990488,294.10564206859715
2020-03-26,6424,5741,255,5,423,843.0,145922,129920,5809.0,54708,114723,7815.428571428572,8194.5,115.34166415496145,241.8721528268195,307.6494537694722
2020-03-27,6172,5552,226,11,383,877.0,152094,135472,6686.0,50021,112956,7145.857142857143,8068.285714285715,105.45999456560881,238.14676128331917,320.6619702417326
2020-03-28,5442,4919,207,7,309,814.0,157536,140391,7500.0,47929,110868,6847.0,7919.142857142857,101.0494008423475,233.7446008176549,332.13541720252994
2020-03-29,4325,3875,145,8,297,788.0,161861,144266,8288.0,45334,107128,6476.285714285715,7652.0,95.57832497625617,225.85950496440574,341.25387697934883
2020-03-30,5362,4689,261,14,398,888.0,167223,148955,9176.0,42214,102776,6030.571428571428,7341.142857142857,89.00038405055098,216.6841206988067,352.558658788205
2020-03-31,4515,4033,176,4,302,870.0,171738,152988,10046.0,39402,98353,5628.857142857143,7025.214285714285,83.07180395981923,207.3590461108599,362.07769830088415
2020-04-01,5701,5043,316,11,331,868.0,177439,158031,10914.0,37941,94988,5420.142857142857,6784.857142857143,79.99155662249383,200.2645681573349,374.09719869109097
2020-04-02,4617,4103,233,4,277,814.0,182056,162134,11728.0,36134,90842,5162.0,6488.714285714285,76.1818325030229,191.52349665798434,383.8312862724951
2020-04-03,4613,4151,229,3,230,759.0,186669,166285,12487.0,34575,84596,4939.285714285715,6042.571428571428,72.89497035456957,178.35496492017836,393.5569405963021
2020-04-04,3951,3341,340,2,268,708.0,190620,169626,13195.0,33084,81013,4726.285714285715,5786.642857142857,69.75147358526623,170.80087442761373,401.8868907877961
2020-04-05,3515,2958,301,2,254,724.0,194135,172584,13919.0,32274,77608,4610.571428571428,5543.428571428572,68.04373892186199,163.62206389811814,409.2976159012108
2020-04-06,3828,3135,323,3,367,733.0,197963,175719,14652.0,30740,72954,4391.428571428572,5211.0,64.80958463339027,153.80996868394124,417.36824342159525
2020-04-07,3587,2888,356,1,342,713.0,201550,178607,15365.0,29812,69214,4258.857142857143,4943.857142857143,62.853068870872825,145.92487283069207,424.93076717175694
2020-04-08,3882,3143,424,4,311,713.0,205432,181750,16078.0,27993,65934,3999.0,4709.571428571428,59.01804497861073,139.00960160110455,433.11524366970167
2020-04-09,3729,2959,421,4,345,642.0,209161,184709,16720.0,27105,63239,3872.1428571428573,4517.071428571428,57.14586179206387,133.32769429508676,440.97714806455895
2020-04-10,3680,2851,534,3,292,643.0,212841,187560,17363.0,26172,60747,3738.8571428571427,4339.071428571428,55.1788044575501,128.07377481211967,448.73574505385227
2020-04-11,3137,2596,400,1,140,593.0,215978,190156,17956.0,25358,58442,3622.5714285714284,4174.428571428572,53.462636536548814,123.21411012181504,455.34952732434493
2020-04-12,2476,1987,299,1,189,521.0,218454,192143,18477.0,24319,56593,3474.1428571428573,4042.3571428571427,51.27209787571301,119.315836797575,460.56971377692383
2020-04-13,2647,1888,455,4,300,563.0,221101,194031,19040.0,23138,53878,3305.4285714285716,3848.4285714285716,48.78217857018166,113.59176320357193,466.1504219917769
2020-04-14,2775,1952,607,3,213,575.0,223876,195983,19615.0,22326,52138,3189.4285714285716,3724.1428571428573,47.070227277978894,109.92329614885172,472.00099444973586
2020-04-15,2823,2069,599,2,153,526.0,226699,198052,20141.0,21267,49260,3038.1428571428573,3518.5714285714284,44.8375223291578,103.85556730776854,477.9527659988595
2020-04-16,2568,1953,479,2,134,463.0,229267,200005,20604.0,20106,47211,2872.285714285714,3372.214285714286,42.38976931161174,99.5356311036756,483.3669173761707
2020-04-17,2248,1682,391,0,175,476.0,231515,201687,21080.0,18674,44846,2667.714285714286,3203.285714285714,39.37066309186499,94.5494675494151,488.10640814571724
2020-04-18,2020,1449,469,1,101,410.0,233535,203136,21490.0,17557,42915,2508.1428571428573,3065.3571428571427,37.01567590788656,90.47831244443537,492.3652032322315
2020-04-19,1314,984,233,2,95,375.0,234849,204120,21865.0,16395,40714,2342.1428571428573,2908.1428571428573,34.56581457594123,85.83791245165425,495.13552835286504
2020-04-20,1617,1255,218,3,141,359.0,236466,205375,22224.0,15365,38503,2195.0,2750.214285714286,32.39425074469881,81.17642931488047,498.5446727364757
2020-04-21,1908,1129,535,1,243,396.0,238374,206504,22620.0,14498,36824,2071.1428571428573,2630.285714285714,30.566342160536504,77.6365694385154,502.5673366102723
2020-04-22,1995,1282,499,1,213,318.0,240369,207786,22938.0,13670,34937,1952.857142857143,2495.5,28.82065783794551,73.65818016710331,506.773423836805
2020-04-23,1751,1054,588,0,109,300.0,242120,208840,23238.0,12853,32959,1836.142857142857,2354.214285714286,27.098164973746425,69.48793428535816,510.4650823499171
2020-04-24,1741,957,690,1,93,313.0,243861,209797,23551.0,12346,31020,1763.7142857142858,2215.714285714286,26.029249573319333,65.39991266518433,514.1356577190365
2020-04-25,948,628,247,1,72,280.0,244809,210425,23831.0,11274,28831,1610.5714285714287,2059.3571428571427,23.769136537307805,60.78481244519437,516.1343397695393
2020-04-26,685,448,139,0,98,259.0,245494,210873,24090.0,10645,27040,1520.7142857142858,1931.4285714285713,22.443006780170442,57.008821356111675,517.5785351330355
2020-04-27,886,548,187,3,148,250.0,246380,211421,24340.0,9914,25279,1416.2857142857142,1805.642857142857,20.901828954308105,53.29607969900692,519.4465016907839
2020-04-28,1430,664,562,1,203,247.0,247810,212085,24587.0,9436,23934,1348.0,1709.5714285714287,19.89405467145968,50.460396831996185,522.4613912817321
2020-04-29,1316,632,586,2,96,224.0,249126,212717,24811.0,8757,22427,1251.0,1601.9285714285713,18.462509194359097,47.283167032304604,525.2359330311641
2020-04-30,1285,614,555,3,113,206.0,250411,213331,25017.0,8291,21144,1184.4285714285713,1510.2857142857142,17.480034684301845,44.57819965804827,527.9451170342189
2020-05-01,1305,612,652,5,36,170.0,251716,213943,25187.0,7855,20201,1122.142857142857,1442.9285714285713,16.56080960622253,42.59005917954186,530.6964673252592
2020-05-02,1206,553,610,2,41,191.0,252922,214496,25378.0,8113,19387,1159.0,1384.7857142857142,17.104754721232766,40.873891258540574,533.2390944907721
2020-05-03,596,372,164,2,58,185.0,253518,214868,25563.0,8024,18669,1146.2857142857142,1333.5,16.917114739698228,39.36012151986867,534.4956498727337
2020-05-04,612,397,182,3,30,177.0,254130,215265,25740.0,7750,17664,1107.142857142857,1261.7142857142858,16.33943659429976,37.24126554860786,535.7859382850836
2020-05-05,545,228,247,5,65,175.0,254675,215493,25915.0,6865,16301,980.7142857142857,1164.357142857143,14.473578350950689,34.36763302241037,536.9349696326827
2020-05-06,378,200,112,4,62,147.0,255053,215693,26062.0,5927,14684,846.7142857142857,1048.857142857143,12.495979444440602,30.958488638799697,537.7319124756046
2020-05-07,385,242,118,1,24,158.0,255438,215935,26220.0,5027,13318,718.1428571428571,951.2857142857143,10.598496485102567,28.07853116940441,538.5436135193215
2020-05-08,347,236,86,4,21,140.0,255785,216171,26360.0,4069,11924,581.2857142857143,851.7142857142857,8.57873129060719,25.13954089682972,539.2751986158663
2020-05-09,279,187,73,4,15,121.0,256064,216358,26481.0,3142,11255,448.85714285714283,803.9285714285714,6.624323842489012,23.729078563721778,539.863418333261
2020-05-10,258,235,11,5,7,106.0,256322,216593,26587.0,2804,10828,400.57142857142856,773.4285714285714,5.911713575537616,22.828828315235842,540.4073634482713
2020-05-11,531,476,10,42,3,118.0,256853,217069,26705.0,2723,10473,389.0,748.0714285714286,5.740940109197193,22.080376703496952,541.5268783942807
2020-05-12,510,433,35,37,5,106.0,257363,217502,26811.0,2688,9553,384.0,682.3571428571429,5.6671491052229355,20.140727456173625,542.6021187379057
2020-05-13,564,485,34,41,4,87.0,257927,217987,26898.0,2874,8801,410.57142857142856,628.6428571428571,6.05929558348613,18.555275027926733,543.7912080590909
2020-05-14,524,441,27,52,4,85.0,258451,218428,26983.0,3013,8040,430.42857142857144,574.2857142857143,6.352351284983893,16.950847770086458,544.8959648043054
2020-05-15,554,477,26,48,3,70.0,259005,218905,27053.0,3220,7289,460.0,520.6428571428571,6.788772365631642,15.367503656238831,546.063970981498
2020-05-16,330,290,26,5,9,58.0,259335,219195,27111.0,3271,6413,467.2857142857143,458.07142857142856,6.896296399994131,13.520620242483142,546.7597147332552
2020-05-17,261,254,4,3,0,53.0,259596,219449,27164.0,3274,6078,467.7142857142857,434.14285714285717,6.902621343191924,12.81433491872954,547.3099847914632
2020-05-18,501,454,1,42,4,65.0,260097,219903,27229.0,3244,5967,463.42857142857144,426.2142857142857,6.8393719112139895,12.580312020411181,548.3662503054948
2020-05-19,547,477,10,60,0,60.0,260644,220380,27289.0,3281,5969,468.7142857142857,426.35714285714283,6.917379543986775,12.58452864920971,549.5194982818924
2020-05-20,443,373,11,56,3,54.0,261087,220753,27343.0,3160,6034,451.42857142857144,431.0,6.662273501675773,12.721569085161903,550.4534815607666
2020-05-21,486,404,7,72,3,62.0,261573,221157,27405.0,3122,6135,446.0,438.2142857142857,6.5821575545037225,12.934508839487615,551.4781223588092
2020-05-22,534,439,9,82,4,64.0,262107,221596,27469.0,3102,6322,443.14285714285717,451.57142857142856,6.539991266518433,13.328763632150075,552.6039622480164
2020-05-23,305,287,7,10,1,57.0,262412,221883,27526.0,3077,6348,439.57142857142856,453.42857142857144,6.487283406536821,13.383579806530951,553.246998139792
2020-05-24,261,253,4,2,2,51.0,262673,222136,27577.0,3077,6351,439.57142857142856,453.64285714285717,6.487283406536821,13.389904749728744,553.7972681980001
2020-05-25,522,451,1,69,1,54.0,263195,222587,27631.0,3098,6342,442.57142857142856,453.0,6.531558008921374,13.370929920135364,554.8978083144161
2020-05-26,537,459,12,64,2,42.0,263732,223046,27673.0,3088,6369,441.14285714285717,454.92857142857144,6.51047486492873,13.427854408915506,556.0299731468211
2020-05-27,396,343,6,47,0,35.0,264128,223389,27708.0,3041,6201,434.42857142857144,442.92857142857144,6.411384088163299,13.07365758983907,556.8648656489299
2020-05-28,495,428,1,64,2,32.0,264623,223817,27740.0,3050,6172,435.7142857142857,440.85714285714283,6.43035891775668,13.012516472260401,557.9084812765658
2020-05-29,472,413,7,50,2,37.0,265095,224230,27777.0,2988,6090,426.85714285714283,435.0,6.299643425002281,12.839634691520713,558.9036056730187
2020-05-30,279,260,6,9,4,39.0,265374,224490,27816.0,2962,6039,423.14285714285717,431.35714285714283,6.244827250621404,12.732110657158225,559.4918253904134
2020-05-31,203,196,1,6,0,32.0,265577,224686,27848.0,2904,5981,414.85714285714283,427.2142857142857,6.122545015464064,12.609828422000884,559.9198132134642
2020-06-01,382,371,2,9,0,25.0,265959,225057,27873.0,2764,5862,394.85714285714283,418.7142857142857,5.827380999567037,12.358939008488411,560.7251893139832
2020-06-02,365,334,5,25,1,34.0,266324,225391,27907.0,2592,5680,370.2857142857143,405.7142857142857,5.464750922893545,11.975225787822275,561.4947240697147
2020-06-03,419,382,6,28,3,23.0,266743,225773,27930.0,2615,5656,373.57142857142856,404.0,5.513242154076628,11.924626242239928,562.3781078030065
2020-06-04,363,317,1,43,2,33.0,267106,226090,27963.0,2483,5533,354.7142857142857,395.2142857142857,5.2349446533737165,11.665303571130396,563.1434259299396
2020-06-05,449,423,0,24,2,16.0,267555,226513,27979.0,2460,5448,351.42857142857144,389.14285714285717,5.186453422190633,11.486096847192915,564.0900590952093
2020-06-06,223,218,0,3,2,21.0,267778,226731,28000.0,2404,5366,343.42857142857144,383.2857142857143,5.068387815831822,11.313215066453226,564.5602132062453
2020-06-07,195,175,3,7,10,13.0,267973,226906,28013.0,2396,5300,342.2857142857143,378.57142857142856,5.051521300637706,11.17406631610177,564.9713345141018
2020-06-08,367,344,0,22,1,18.0,268340,227250,28031.0,2381,5145,340.14285714285717,367.5,5.0198965846487384,10.847277584215774,565.7450858986319
2020-06-09,304,269,0,34,1,10.0,268644,227519,28041.0,2320,4912,331.42857142857144,350.85714285714283,4.891289406293605,10.35604032918715,566.3860134760083
2020-06-10,312,260,1,51,0,25.0,268956,227779,28066.0,2213,4828,316.14285714285717,344.85714285714283,4.665699765572305,10.178941919648933,567.0438075685788
2020-06-11,284,238,0,46,0,14.0,269240,228017,28080.0,2134,4617,304.85714285714283,329.7857142857143,4.499142928030411,9.734087581404127,567.64256885797
2020-06-12,327,298,0,29,0,8.0,269567,228315,28088.0,2012,4472,287.42857142857144,319.42857142857144,4.241928571320144,9.428381993510778,568.3319876665295
2020-06-13,117,112,0,5,0,9.0,269684,228427,28097.0,1906,4310,272.2857142857143,307.85714285714283,4.018447244998108,9.08683506082993,568.5786604512434
2020-06-14,139,134,0,5,0,9.0,269823,228561,28106.0,1850,4246,264.2857142857143,303.2857142857143,3.9003816386392973,8.951902939277003,568.8717161527411
2020-06-15,300,276,0,24,0,10.0,270123,228837,28116.0,1783,4164,254.71428571428572,297.42857142857144,3.7591245738885766,8.779021158537315,569.5042104725205
2020-06-16,268,253,0,15,0,6.0,270391,229090,28122.0,1747,4067,249.57142857142858,290.5,3.683225255515055,8.57451466180866,570.0692387315233
2020-06-17,281,264,0,17,0,5.0,270672,229354,28127.0,1716,3929,245.14285714285714,280.64285714285717,3.6178675091378563,8.283567274710162,570.6616750777167
2020-06-18,284,268,0,16,0,4.0,270956,229622,28131.0,1716,3850,245.14285714285714,275.0,3.6178675091378563,8.117010437168267,571.2604363671078
2020-06-19,263,247,0,16,0,4.0,271219,229869,28135.0,1652,3664,236.0,261.7142857142857,3.4829353875849294,7.724863958905073,571.8149230541144
2020-06-20,241,237,0,4,0,3.0,271460,230106,28138.0,1776,3682,253.71428571428572,263.0,3.7443663730937256,7.762813618091834,572.3230268243371
2020-06-21,224,222,0,2,0,5.0,271684,230328,28143.0,1861,3711,265.85714285714283,265.07142857142856,3.9235730970312064,7.823954735670504,572.7952892497724
2020-06-22,289,265,0,24,0,1.0,271973,230593,28144.0,1850,3633,264.2857142857143,259.5,3.9003816386392973,7.659506212527874,573.4045921111598
2020-06-23,328,304,1,23,0,4.0,272301,230897,28148.0,1910,3657,272.85714285714283,261.2142857142857,4.026880502595167,7.710105758110221,574.0961192341185
2020-06-24,381,380,0,1,0,1.0,272682,231277,28149.0,2010,3726,287.14285714285717,266.14285714285717,4.2377119425216145,7.855579451659471,574.8993870202384
2020-06-25,346,314,0,32,0,5.0,273028,231591,28154.0,2072,3788,296.0,270.57142857142856,4.368427435276013,7.986294944413869,575.6288638023838
2020-06-26,376,337,0,39,0,5.0,273404,231928,28159.0,2185,3837,312.14285714285717,274.07142857142856,4.606666962392899,8.08960234997783,576.4215900165073
2020-06-27,287,286,0,1,0,1.0,273691,232214,28160.0,2231,4007,318.7142857142857,286.2142857142857,4.703649424759066,8.448015797852792,577.0266762490961
2020-06-28,247,244,0,3,0,7.0,273938,232458,28167.0,2254,4115,322.0,293.92857142857144,4.752140655942149,8.675713752973357,577.5474299057145
2020-06-29,377,360,0,17,0,6.0,274315,232818,28173.0,2342,4192,334.57142857142856,299.42857142857144,4.9376723230774235,8.83805396171672,578.3422644342372
2020-06-30,421,401,0,18,2,3.0,274736,233219,28176.0,2435,4345,347.85714285714283,310.35714285714283,5.133745562209021,9.160626064804188,579.2298647963275
2020-07-01,541,517,0,24,0,6.0,275277,233736,28182.0,2595,4605,370.7142857142857,328.92857142857144,5.471075866091339,9.708787808612954,580.3704628863296
2020-07-02,417,395,0,21,1,0.0,275694,234131,28182.0,2666,4738,380.85714285714283,338.42857142857144,5.620766188439117,9.98919362371513,581.2496299908229
2020-07-03,537,528,0,9,0,5.0,276231,234659,28187.0,2827,5012,403.85714285714283,358.0,5.960204806720699,10.566871769113598,582.381794823228
2020-07-04,407,406,0,1,0,3.0,276638,235065,28190.0,2947,5178,421.0,369.85714285714283,6.213202534632437,10.916851959391503,583.2398787837286
2020-07-05,420,417,0,3,0,0.0,277058,235482,28190.0,3120,5374,445.7142857142857,383.85714285714283,6.577940925705193,11.330081581647342,584.1253708314197
2020-07-06,694,688,1,4,1,6.0,277752,236170,28196.0,3437,5779,491.0,412.7857142857143,7.246276590272035,12.18394891334946,585.5885410245093
2020-07-07,778,773,0,5,0,2.0,278530,236943,28198.0,3794,6229,542.0,444.92857142857144,7.998944830809456,13.132690393018477,587.228809627137
2020-07-08,888,884,0,4,0,3.0,279418,237827,28201.0,4141,6736,591.5714285714286,481.14285714285717,8.730529927354233,14.201605793445571,589.1009928136839
2020-07-09,917,913,0,2,2,2.0,280335,238740,28203.0,4641,7307,663.0,521.9285714285714,9.784687126986475,15.405453315425593,591.0343171178095
2020-07-10,1117,1111,0,6,0,3.0,281452,239851,28206.0,5221,8048,745.8571428571429,574.8571428571429,11.007509478559877,16.967714285280575,593.3893043017879
2020-07-11,869,868,0,1,0,2.0,282321,240719,28208.0,5683,8630,811.8571428571429,616.4285714285714,11.981550731020068,18.194753265652505,595.2214295147487
2020-07-12,839,830,0,6,3,2.0,283160,241549,28210.0,6102,9222,871.7142857142857,658.7142857142857,12.864934464311888,19.44287539001708,596.9903052957316
2020-07-13,1356,1345,0,10,1,1.0,284516,242894,28211.0,6764,10201,966.2857142857143,728.6428571428571,14.260638596624977,21.50691518689701,599.8491796211342
2020-07-14,1482,1475,0,7,0,2.0,285998,244369,28213.0,7468,11262,1066.857142857143,804.4285714285714,15.744891933707175,23.74383676451663,602.9737015608442
2020-07-15,1802,1793,0,7,2,5.0,287800,246162,28218.0,8382,12523,1197.4285714285713,894.5,17.671891294634914,26.402421221989147,606.7728841083187
2020-07-16,1670,1662,0,7,1,0.0,289470,247824,28218.0,9135,13776,1305.0,984.0,19.259452037281072,29.044139164267545,610.2937691550904
2020-07-17,2021,2010,0,5,6,1.0,291491,249834,28219.0,10039,15260,1434.142857142857,1090.0,21.165368254216165,32.172877732776044,614.554672556004
2020-07-18,1774,1768,0,3,3,2.0,293265,251602,28221.0,10944,16627,1563.4285714285713,1187.642857142857,23.073392785550524,35.05494351657059,618.2948223002992
2020-07-19,1567,1560,0,6,1,4.0,294832,253162,28225.0,11672,17774,1667.4285714285713,1269.5714285714287,24.60824566821507,37.473180132526956,621.5985509639466
2020-07-20,2310,2301,0,9,0,3.0,297142,255463,28228.0,12626,19390,1803.7142857142858,1385.0,26.61957760511339,40.880216201738364,626.4687572262476
2020-07-21,2327,2309,0,17,1,4.0,299469,257772,28232.0,13471,20939,1924.4285714285713,1495.642857142857,28.401103272491877,44.14599520619905,631.374804833336
2020-07-22,2369,2361,0,7,1,2.0,301838,260133,28234.0,14038,22420,2005.4285714285713,1601.4285714285713,29.596517536874842,47.26840883150975,636.3694016451936
2020-07-23,2258,2250,0,8,0,1.0,304096,262383,28235.0,14626,23761,2089.4285714285716,1697.2142857142858,30.836206403642358,50.09565844092343,641.1299755587328
2020-07-24,2499,2491,0,7,1,5.0,306595,264874,28240.0,15104,25143,2157.714285714286,1795.9285714285713,31.84398068649078,53.00934894070695,646.3986532424948
2020-07-25,2063,2059,0,4,0,6.0,308658,266933,28246.0,15393,26337,2199.0,1881.2142857142858,32.453283547878215,55.52667633342874,650.7481058481774
2020-07-26,1875,1872,0,3,0,7.0,310533,268805,28253.0,15701,27373,2243.0,1955.2142857142858,33.10264438285168,57.71089005106675,654.7011953467983
2020-07-27,3001,2989,0,12,0,7.0,313534,271794,28260.0,16392,29018,2341.714285714286,2072.714285714286,34.559489632743436,61.17906723785683,661.028246858991
2020-07-28,3121,3113,0,8,0,11.0,316655,274907,28271.0,17186,30657,2455.1428571428573,2189.785714285714,36.23349126575944,64.63459453825132,667.6082960990955
2020-07-29,3195,3183,0,12,0,5.0,319850,278090,28276.0,18012,32050,2573.1428571428573,2289.285714285714,37.974958959551905,67.57147649642674,674.3443606047455
2020-07-30,3109,3097,0,12,0,8.0,322959,281187,28284.0,18863,33489,2694.714285714286,2392.0714285714284,39.76913451332598,70.60534091696834,680.8991100720588
2020-07-31,3599,3591,0,8,0,10.0,326558,284778,28294.0,19963,35067,2851.8571428571427,2504.785714285714,42.08828035251691,73.9322610390077,688.4869335950117
2020-08-01,3588,3583,0,4,1,6.0,330146,288361,28300.0,21488,36881,3069.714285714286,2634.3571428571427,45.30345981139526,77.75674335927347,696.0515656595727
2020-08-02,2757,2755,0,2,0,11.0,332903,291116,28311.0,22370,38071,3195.714285714286,2719.3571428571427,47.16299311154653,80.2656374943982,701.8641884583449
2020-08-03,4069,4063,0,6,0,10.0,336972,295179,28321.0,23438,39830,3348.285714285714,2845.0,49.414672889961,83.97416252270443,710.442919748952
2020-08-04,4572,4564,0,8,0,12.0,341544,299743,28333.0,24889,42075,3555.5714285714284,3005.3571428571427,52.473837083293766,88.70732834905321,720.0821331823893
2020-08-05,4544,4539,0,5,0,9.0,346088,304282,28342.0,26238,44250,3748.285714285714,3160.714285714286,55.31795320790156,93.29291216745347,729.6623138126471
2020-08-06,4495,4488,0,7,0,23.0,350583,308770,28365.0,27624,46487,3946.285714285714,3320.5,58.240076965282135,98.00921147860811,739.139187037341
2020-08-07,5236,5227,0,8,1,18.0,355819,313997,28383.0,29261,49224,4180.142857142857,3516.0,61.6913876368781,103.77966798939501,750.1783212318898
2020-08-08,4163,4162,0,1,0,29.0,359982,318159,28412.0,29836,51324,4262.285714285715,3666.0,62.903668416455176,108.20712822785043,758.9552340760279
2020-08-09,3974,3970,0,4,0,14.0,363956,322129,28426.0,31053,53423,4436.142857142857,3815.9285714285716,65.46948704036005,112.63248015190658,767.3336754987049
2020-08-10,5962,5950,0,12,0,20.0,369918,328079,28446.0,32946,56384,4706.571428571428,4027.4285714285716,69.46052619816773,118.87519908812872,779.9034459471197
2020-08-11,6286,6279,0,7,0,25.0,376204,334358,28471.0,34660,59549,4951.428571428572,4253.5,73.07417707850705,125.54801416180082,793.1563102608964
2020-08-12,6407,6402,0,4,1,23.0,382611,340760,28494.0,36523,62761,5217.571428571428,4482.928571428572,77.00196680433679,132.31992001223836,806.6642806169839
2020-08-13,6219,6213,0,5,1,21.0,388830,346973,28515.0,38247,65871,5463.857142857143,4705.071428571428,80.63670082866876,138.87677779395088,819.7758878660097
2020-08-14,7035,7026,0,8,1,31.0,395865,353999,28546.0,40046,69307,5720.857142857143,4950.5,84.42955843294557,146.12094606982367,834.6078796648353
2020-08-15,5475,5472,1,1,1,28.0,401340,359471,28574.0,41358,71194,5908.285714285715,5085.285714285715,87.19566692478057,150.09933534123576,846.1509010008084
2020-08-16,4881,4873,0,5,3,20.0,406221,364344,28594.0,42265,73318,6037.857142857143,5237.0,89.10790808491346,154.5773951252735,856.4415835836184
2020-08-17,7048,7033,0,15,0,30.0,413269,371377,28624.0,43351,76297,6193.0,5449.785714285715,91.3975375225147,160.85806372068242,871.3009834696345
2020-08-18,8304,8297,0,7,0,34.0,421573,379674,28658.0,45369,80029,6481.285714285715,5716.357142857143,95.65211598023042,168.72629305873747,888.8084262411268
2020-08-19,8419,8411,0,7,1,41.0,429992,388085,28699.0,47381,83904,6768.714285714285,5993.142857142857,99.89404455155056,176.89601135588734,906.5583251685345
2020-08-20,8417,8408,0,7,2,33.0,438409,396493,28732.0,49579,87826,7082.714285714285,6273.285714285715,104.52811960113391,185.16482042980266,924.3040074671436
2020-08-21,9637,9631,0,6,0,36.0,448046,406124,28768.0,52181,92227,7454.428571428572,6587.642857142857,110.0139536680201,194.44351210096565,944.6218333328554
2020-08-22,6598,6595,0,3,0,38.0,454644,412719,28806.0,53304,94662,7614.857142857143,6761.571428571428,112.38159073839411,199.5772576631747,958.5324917392026
2020-08-23,5831,5828,0,3,0,47.0,460475,418547,28853.0,54254,96519,7750.571428571428,6894.214285714285,114.38448941769536,203.49239750260884,970.8260730013137
2020-08-24,8032,8020,0,12,0,49.0,468507,426567,28902.0,55238,98589,7891.142857142857,7042.071428571428,116.45907078657163,207.8566083090863,987.7600542562061
2020-08-25,10052,10043,0,9,0,36.0,478559,436610,28938.0,56986,102355,8140.857142857143,7311.071428571428,120.14440435648594,215.79652033671636,1008.9528305976127
2020-08-26,9764,9754,0,10,0,45.0,488323,446364,28983.0,58331,105712,8333.0,7550.857142857143,122.98008722349668,222.87413177504723,1029.5384123920312
2020-08-27,9347,9339,0,7,1,41.0,497670,455703,29024.0,59261,108840,8465.857142857143,7774.285714285715,124.94081961481264,229.46893921594653,1049.2448270819561
2020-08-28,10784,10772,0,10,2,60.0,508454,466475,29084.0,60408,112589,8629.714285714286,8042.071428571428,127.35905623076901,237.3730098987891,1071.9808895636245
2020-08-29,7188,7182,0,3,3,43.0,515642,473657,29127.0,60998,114302,8714.0,8164.428571428572,128.60296172633505,240.98455246472918,1087.1354534655375
2020-08-30,6298,6290,0,8,0,52.0,521940,479947,29179.0,61465,115719,8780.714285714286,8265.642857142857,129.58754455079156,243.97203396848695,1100.4136175521053
2020-08-31,8186,8178,0,8,0,61.0,530126,488125,29240.0,61619,116857,8802.714285714286,8346.92857142857,129.9122249682783,246.3712957548499,1117.6722792244843
2020-09-01,11087,11064,0,23,0,62.0,541213,499189,29302.0,62654,119640,8950.57142857143,8545.714285714286,132.09433037151703,252.23873472800298,1141.0471609691297
2020-09-02,10243,10219,1,20,3,73.0,551456,509408,29375.0,63133,121464,9019.0,8676.0,133.10421296876473,256.0843001922614,1162.6426253607958
2020-09-03,10132,10112,1,18,1,63.0,561588,519520,29438.0,63918,123179,9131.142857142857,8798.5,134.75923977218736,259.700059387,1184.0040668541435
2020-09-04,11256,11236,0,20,0,67.0,572844,530756,29505.0,64390,124798,9198.57142857143,8914.142857142857,135.7543641686402,263.1134203994092,1207.7352537322647
2020-09-05,8622,8610,0,11,1,58.0,581466,539366,29563.0,65824,126822,9403.42857142857,9058.714285714286,138.77768701718546,267.3806487435205,1225.913140482723
2020-09-06,7348,7338,1,9,0,55.0,588814,546704,29618.0,66874,128339,9553.42857142857,9167.07142857143,140.99141713641316,270.57896168720475,1241.4050346885185
2020-09-07,9212,9191,0,20,1,71.0,598026,555895,29689.0,67900,129519,9700.0,9251.357142857143,143.15454771005852,273.06677267833686,1260.8268269345429
2020-09-08,11143,11127,1,15,0,79.0,609169,567022,29768.0,67956,130610,9708.0,9329.285714285714,143.27261331641733,275.3669436879344,1284.319774285547
2020-09-09,11656,11635,3,17,1,80.0,620825,578657,29848.0,69369,132502,9909.857142857143,9464.42857142857,146.25166156257805,279.3558745313428,1308.894286923374
2020-09-10,11535,11522,0,12,1,76.0,632360,590179,29924.0,70772,134690,10110.285714285714,9620.714285714286,149.20962666474614,283.96886643693347,1333.2136935188898
2020-09-11,11895,11885,0,9,1,85.0,644255,602064,30009.0,71411,135801,10201.57142857143,9700.07142857143,150.55683956587615,286.3112037345163,1358.2920932981408
2020-09-12,9139,9134,0,5,0,97.0,653394,611198,30106.0,71928,137752,10275.42857142857,9839.42857142857,151.64683811029587,290.42452512748133,1377.559978593019
2020-09-13,7908,7894,0,14,0,94.0,661302,619092,30200.0,72488,139362,10355.42857142857,9954.42857142857,152.827494173884,293.81891131029715,1394.2325288624024
2020-09-14,10281,10262,1,17,1,89.0,671583,629354,30289.0,73557,141457,10508.142857142857,10104.07142857143,155.0812822666977,298.23582997675624,1415.9081092012407
2020-09-15,12203,12183,0,19,1,115.0,683786,641537,30404.0,74617,142573,10659.57142857143,10183.785714285714,157.31609552991807,300.5887088463354,1441.6358698154652
2020-09-16,11905,11889,0,15,1,101.0,695691,653426,30505.0,74866,144235,10695.142857142857,10302.5,157.84106581533493,304.092727377913,1466.7353527387088
2020-09-17,11503,11489,0,13,1,110.0,707194,664915,30615.0,74834,145606,10690.57142857143,10400.42857142857,157.77359975455846,306.98322641930463,1490.9872932734481
2020-09-18,14194,14162,0,32,0,103.0,721388,679077,30718.0,77133,148544,11019.0,10610.285714285714,162.6206145584675,313.1774541243437,1520.9127078566082
2020-09-19,8356,8329,0,26,1,105.0,729744,687406,30823.0,76350,148278,10907.142857142857,10591.285714285714,160.96980438384344,312.6166424941393,1538.5297829768624
2020-09-20,7119,7081,0,38,0,90.0,736863,694487,30913.0,75561,148049,10794.42857142857,10574.92857142857,159.30634432282375,312.13383849670777,1553.5388731852263
2020-09-21,9912,9781,0,130,1,109.0,746775,704268,31022.0,75192,148749,10741.714285714286,10624.92857142857,158.52837630949514,313.6096585761929,1574.4364855107358
2020-09-22,12271,12163,0,108,0,117.0,759046,716431,31139.0,75260,149877,10751.42857142857,10705.5,158.67174168864514,315.98783721856324,1600.3076115041104
2020-09-23,11610,11488,0,121,1,103.0,770656,727919,31242.0,74965,149831,10709.285714285714,10702.214285714286,158.04978894086213,315.89085475619703,1624.7851416795709
2020-09-24,10934,10764,0,169,1,104.0,781590,738683,31346.0,74396,149230,10628.0,10659.285714285714,156.85015804768062,314.6237578022391,1647.8374513211288
2020-09-25,11595,11387,0,208,0,116.0,793185,750070,31462.0,71797,148930,10256.714285714286,10637.857142857143,151.37064892399223,313.9912634824598,1672.2833567806006
2020-09-26,7599,7429,0,170,0,102.0,800784,757499,31564.0,71040,147390,10148.57142857143,10527.857142857143,149.774654923749,310.7444593075924,1688.3044379006114
2020-09-27,6203,6034,0,168,1,104.0,806987,763533,31668.0,70124,145685,10017.714285714286,10406.07142857143,147.84343893402274,307.1497832568465,1701.382312119249
2020-09-28,8960,8566,0,392,2,135.0,815947,772099,31803.0,69172,144364,9881.714285714286,10311.714285714286,145.83632362592294,304.3646999354181,1720.2728091366587
2020-09-29,10551,10104,0,446,1,121.0,826498,782203,31924.0,67452,142712,9636.0,10193.714285714286,142.21002285918803,300.8817645478332,1742.5176343632984
2020-09-30,9918,9289,0,626,3,132.0,836416,791492,32056.0,65760,140725,9394.285714285714,10051.785714285714,138.64275489563252,296.6925438364947,1763.4278965752035
2020-10-01,9871,9166,0,705,0,114.0,846287,800658,32170.0,64697,139093,9242.42857142857,9935.214285714286,136.4016166892144,293.251774736895,1784.2390680103433
2020-10-02,10548,9600,1,943,4,127.0,856835,810258,32297.0,63650,135447,9092.857142857143,9674.785714285714,134.19421151318448,285.5648604371767,1806.477568293785
2020-10-03,7582,6836,0,746,0,93.0,864417,817094,32390.0,63633,134673,9090.42857142857,9619.5,134.15837016839697,283.933025092146,1822.4628080690084
2020-10-04,7114,6354,0,759,1,76.0,871531,823448,32466.0,64544,134668,9220.57142857143,9619.142857142857,136.0790445861269,283.9224835201497,1837.461356705376
2020-10-05,10960,9521,1,1434,4,121.0,882491,832969,32587.0,66544,135716,9506.285714285714,9694.0,140.29567338465588,286.13199701057886,1860.5684825213145
2020-10-06,12311,10871,0,1438,2,120.0,894802,843840,32707.0,68304,135756,9757.714285714286,9696.857142857143,144.0063067273614,286.2163295865494,1886.5239410906597
2020-10-07,12002,10469,0,1533,0,122.0,906804,854309,32829.0,70388,136148,10055.42857142857,9724.857142857143,148.40003393542858,287.0427888310611,1911.827930510632
2020-10-08,12179,10748,0,1428,3,112.0,918983,865057,32941.0,72696,137393,10385.142857142857,9813.785714285714,153.266023568931,289.6676402581454,1937.5050915792742
2020-10-09,12922,11289,1,1632,0,128.0,931905,876346,33069.0,75070,138720,10724.285714285714,9908.57142857143,158.2711619527849,292.4653734659694,1964.74873024657
2020-10-10,10081,8838,0,1243,0,103.0,941986,885184,33172.0,77569,141202,11081.285714285714,10085.857142857143,163.53983963654684,297.6982098049438,1986.002647705555
2020-10-11,8460,7341,1,1118,0,89.0,950446,892525,33261.0,78915,143459,11273.57142857143,10247.07142857143,166.37763081795683,302.45667540408374,2003.8389875233327
2020-10-12,10108,8759,1,1346,2,102.0,960554,901284,33363.0,78063,144607,11151.857142857143,10329.07142857143,164.5813469497835,304.8770203344394,2025.1498294710982
2020-10-13,13544,11480,0,2060,4,118.0,974098,912764,33481.0,79296,147600,11328.0,10542.857142857143,167.18089860407662,311.187205331438,2053.704839694736
2020-10-14,15501,13505,4,1990,2,118.0,989599,926269,33599.0,82795,153183,11827.857142857143,10941.642857142857,174.55789068710303,322.9579246225316,2086.385821197735
2020-10-15,15548,13340,2,2201,5,112.0,1005147,939609,33711.0,86164,158860,12309.142857142857,11347.142857142857,181.6608018982251,334.9268254671561,2119.165893477499
2020-10-16,16313,13831,1,2473,8,107.0,1021460,953440,33818.0,89555,164625,12793.57142857143,11758.92857142857,188.81009602613096,347.08125797891586,2153.558826272701
2020-10-17,13165,11411,1,1745,8,87.0,1034625,964851,33905.0,92639,170208,13234.142857142857,12157.714285714286,195.31213763346264,358.85197727000946,2181.314785339018
2020-10-18,11555,9767,3,1782,3,102.0,1046180,974618,34007.0,95734,174649,13676.285714285714,12474.92857142857,201.8373706991862,368.21500151714304,2205.676358222519
2020-10-19,17543,14488,3,3050,2,118.0,1063723,989106,34125.0,103169,181232,14738.42857142857,12945.142857142857,217.51268825771766,382.0940352075011,2242.6625177288156
2020-10-20,19360,16265,1,3094,0,140.0,1083083,1005371,34265.0,108985,188281,15569.285714285714,13448.642857142857,229.7746448038399,396.9555434079165,2283.4794844985763
2020-10-21,18704,15752,3,2948,1,123.0,1101787,1021123,34388.0,112188,194983,16026.857142857143,13927.357142857143,236.52757582468405,411.0854665117871,2322.9133970224193
2020-10-22,17851,15190,2,2658,1,140.0,1119638,1036313,34528.0,114491,200655,16355.857142857143,14332.5,241.38302388619016,423.0438257844152,2360.5489173636893
2020-10-23,17126,14529,1,2596,0,145.0,1136764,1050842,34673.0,115304,204859,16472.0,14632.785714285714,243.09708349279217,431.90717951892316,2396.655909765493
2020-10-24,12547,10859,7,1681,0,114.0,1149311,1061701,34787.0,114686,207325,16383.714285714286,14808.92857142857,241.79414519404673,437.10628282750935,2423.1089305330647
2020-10-25,9141,7800,1,1338,2,114.0,1158452,1069501,34901.0,112272,208006,16038.857142857143,14857.57142857143,236.70467423422227,438.5420449334085,2442.381032456741
2020-10-26,8822,6964,1,1857,0,101.0,1167274,1076465,35002.0,103551,206720,14793.0,14765.714285714286,218.31806435823668,435.83075261595434,2460.9805820870524
2020-10-27,7172,5828,0,1344,0,112.0,1174446,1082293,35114.0,91363,200348,13051.857142857143,14310.57142857143,192.62192846000116,422.39657326384105,2476.1014129585774
2020-10-28,4819,3476,1,1341,1,42.0,1179265,1085769,35156.0,77478,189666,11068.285714285714,13547.57142857143,163.34798302621377,399.8755588508978,2486.261380048633
2020-10-29,5,3,0,2,0,,1179270,1085772,,59632,174123,8518.857142857143,12437.357142857143,125.72300425693977,367.10602814312995,2486.271921620629
